0 0 0 0 0 0 0 0 0 0 0 0 0 0 0 0 0 0 0 0 0 0 0 0 0 0 0 0 0 0 0 0 0 0 0 0 0 0 0 0 0 0 0 0 0 0 0 0 0 0
0 6 6 6 6 6 6 6 6 6 6 6 6 42 42 42 42 42 42 42 42 42 42 42 42 42 42 42 42 42 42 42 42 42 6 6 6 6 6 6 6 6 6 6 6 6 6 6 6 0
0 6 6 6 6 6 6 6 6 6 6 6 6 42 42 42 42 42 42 42 42 42 42 42 42 42 42 42 42 42 42 42 42 42 6 6 6 6 6 6 6 6 6 6 6 6 6 6 6 0
0 6 6 6 6 6 6 6 6 6 6 6 6 42 42 42 42 42 42 42 42 42 42 42 42 42 42 42 42 42 42 42 42 42 6 6 6 6 6 6 6 6 6 6 6 6 6 6 6 0
0 6 6 6 6 6 6 6 6 6 6 6 6 42 42 42 42 42 42 42 42 42 42 42 42 42 42 42 42 42 42 42 42 42 6 6 6 6 6 6 6 6 6 6 6 6 6 6 6 0
0 6 6 6 6 6 6 6 6 6 6 6 6 42 42 42 42 42 42 42 42 42 42 42 42 42 42 42 42 42 42 42 42 42 6 6 6 6 6 6 6 6 6 6 6 6 6 6 6 0
0 6 6 6 6 6 6 6 6 6 6 6 6 42 42 42 42 42 42 42 42 42 42 42 42 42 42 42 42 42 42 42 42 42 6 6 6 6 6 6 6 6 6 6 6 6 6 6 6 0
0 6 6 6 6 6 6 6 6 6 6 6 6 42 42 42 42 42 42 42 42 42 42 42 42 42 42 42 42 42 42 42 42 42 6 6 6 6 6 6 6 6 6 6 6 6 6 6 6 0
0 6 6 6 6 6 6 6 6 6 6 6 6 43 43 43 43 43 43 43 43 43 43 41 42 43 43 43 43 43 43 43 43 43 6 6 6 6 6 6 6 6 6 6 6 6 6 6 6 0
0 6 6 6 6 6 6 6 6 6 6 6 6 6 6 6 6 6 6 6 6 4 4 6 4 4 6 6 6 6 6 6 6 6 6 6 6 6 6 6 6 6 6 6 6 6 6 6 6 0
0 6 6 6 6 6 6 6 6 6 6 6 6 6 6 6 6 6 6 6 6 4 4 6 4 4 6 6 6 6 6 6 6 6 6 6 6 6 6 6 6 6 6 6 6 6 6 6 6 0
0 6 6 6 6 6 6 6 6 6 6 6 6 6 6 6 6 6 6 6 6 4 4 6 4 4 6 6 6 6 6 6 6 6 6 6 6 6 6 6 6 6 6 6 6 6 6 6 6 0
0 6 6 6 6 6 6 6 4 6 6 6 6 6 6 6 6 6 6 6 6 4 4 6 4 4 6 6 6 6 6 6 6 6 6 6 6 6 6 6 6 6 6 6 6 6 6 6 6 0
0 6 6 6 4 6 6 4 4 6 6 6 6 6 6 6 6 6 6 6 6 4 4 6 4 4 6 6 6 6 6 6 6 6 6 6 6 6 6 6 6 6 6 6 6 6 6 6 6 0
0 6 6 6 4 4 4 4 4 6 6 6 6 6 6 6 6 6 6 6 6 4 4 6 4 4 6 6 6 6 6 6 6 6 6 6 6 6 6 6 6 6 6 6 6 6 6 6 6 0
0 6 6 4 6 4 4 4 4 4 4 4 6 6 6 6 6 6 6 6 6 4 4 6 4 4 4 4 4 4 6 6 6 6 6 6 6 6 6 6 6 6 6 6 6 6 6 6 6 0
0 6 6 4 4 6 6 6 4 4 4 6 4 6 6 6 6 6 6 6 6 4 4 6 4 4 6 4 6 4 4 4 6 6 6 6 6 6 6 6 6 6 6 6 6 6 6 6 6 0
0 6 4 6 6 6 6 6 6 4 6 4 4 4 4 4 6 6 6 6 6 4 4 6 4 4 4 4 4 6 6 4 4 6 4 6 6 6 6 6 6 6 6 6 6 6 6 6 6 0
0 6 4 4 6 6 6 6 6 6 6 4 6 6 6 6 4 6 6 6 6 4 4 6 4 4 7 4 4 6 4 4 4 4 4 6 6 6 6 6 6 6 6 6 6 6 6 6 6 0
0 6 6 4 6 6 6 6 6 6 4 4 6 4 6 6 6 4 4 4 6 4 4 6 4 6 6 6 4 6 6 6 6 6 4 6 6 6 6 6 6 6 6 6 6 6 6 6 6 0
0 6 6 4 4 4 6 6 6 6 4 6 6 4 4 4 6 6 4 4 4 4 4 6 4 4 4 6 4 4 4 4 6 4 4 6 6 6 6 6 6 6 6 6 6 6 6 6 6 0
0 6 6 6 6 4 4 6 6 4 6 6 6 6 4 6 6 6 6 4 4 4 4 6 4 4 4 6 6 6 6 4 6 4 4 4 4 6 6 6 6 6 6 6 6 6 6 6 6 0
0 6 6 6 6 8 8 8 2 8 8 8 4 6 4 6 6 6 6 6 6 4 6 6 6 4 4 4 4 4 6 6 6 6 6 4 4 6 6 6 6 6 6 6 6 6 6 6 6 0
0 6 6 6 6 8 2 2 2 2 2 8 4 6 4 4 4 6 4 4 4 6 6 6 6 6 4 4 4 4 4 4 4 4 6 4 4 4 6 6 6 6 6 6 6 6 6 6 6 0
0 6 6 6 6 8 2 2 2 2 2 2 6 6 6 6 6 6 6 6 6 6 6 6 6 6 6 6 6 6 6 6 6 6 6 6 4 4 6 6 6 6 6 6 6 6 6 6 6 0
0 6 6 6 6 8 2 2 2 2 2 8 4 6 4 4 4 4 4 4 4 4 4 4 4 4 4 4 4 6 6 4 4 4 4 6 4 4 6 6 6 6 6 6 6 6 6 6 6 0
0 6 6 6 6 8 8 8 8 8 8 8 4 6 4 4 6 6 6 6 6 6 6 6 6 6 6 6 4 4 6 4 4 4 4 6 4 4 6 6 6 6 6 6 6 6 6 6 6 0
0 6 6 6 6 6 6 6 6 6 6 6 4 6 6 6 6 4 4 4 4 4 4 6 4 4 4 4 4 4 6 4 4 4 6 6 4 6 6 6 6 6 6 6 6 6 6 6 6 0
0 6 6 6 6 6 6 6 6 6 6 6 4 4 4 4 6 6 6 6 6 6 6 6 6 6 6 6 6 6 6 4 4 4 4 6 4 4 6 6 6 6 6 6 6 6 6 6 6 0
0 6 6 6 6 6 6 6 6 6 6 6 6 4 6 4 4 6 4 4 4 4 4 4 4 4 4 6 4 4 4 4 4 4 6 6 4 6 6 6 6 6 6 6 6 6 6 6 6 0
0 6 6 6 6 6 6 6 6 6 6 6 6 6 6 4 4 6 4 4 4 9 4 4 4 4 4 6 6 6 4 4 6 4 6 4 4 4 6 6 6 6 6 6 6 6 6 6 6 0
0 6 6 6 6 6 6 6 6 6 6 6 6 6 6 4 4 6 6 6 6 6 4 4 4 4 4 6 6 6 6 6 6 4 6 6 4 4 6 6 6 6 6 6 6 6 6 6 6 0
0 6 6 6 6 6 6 6 6 6 6 6 6 6 6 4 4 4 4 4 4 4 4 4 4 4 4 6 6 6 6 4 6 4 4 6 4 4 6 6 6 6 6 6 6 6 6 6 6 0
0 6 6 6 6 6 6 6 6 6 6 6 6 6 6 4 4 4 4 4 4 4 4 4 4 4 4 4 6 6 4 4 6 4 6 6 4 6 6 6 6 6 6 6 6 6 6 6 6 0
0 6 6 6 6 6 6 6 6 6 6 6 6 6 6 4 4 4 4 4 4 4 4 4 4 4 4 4 4 4 4 6 6 6 6 6 4 4 6 6 6 6 6 6 6 6 6 6 6 0
0 6 6 6 6 6 6 6 6 6 6 6 6 6 6 4 4 4 4 4 4 4 4 4 4 4 4 4 4 4 4 6 4 4 4 4 4 4 6 6 6 6 6 6 6 6 6 6 6 0
0 6 6 6 6 6 6 6 6 6 6 6 6 6 6 6 6 6 4 6 4 6 6 6 6 6 4 6 6 6 6 6 4 6 6 6 6 6 6 6 6 6 6 6 6 6 6 6 6 0
0 6 6 6 6 6 6 6 6 6 6 6 6 6 6 6 6 6 4 6 6 4 6 6 6 6 6 6 4 6 4 6 4 4 6 6 6 4 6 6 6 6 6 6 6 6 6 6 6 0
0 6 6 6 6 6 6 6 6 6 6 6 6 6 6 6 6 6 6 4 4 6 6 4 4 4 4 6 6 4 4 4 4 6 4 6 6 6 6 6 6 6 6 6 6 6 6 6 6 0
0 6 6 6 6 6 6 6 6 6 6 6 6 6 6 6 6 6 6 6 4 6 6 4 6 4 4 6 4 6 6 6 6 6 6 4 6 6 6 6 6 6 6 6 6 6 6 6 6 0
0 6 6 6 6 6 6 6 6 6 6 6 6 6 6 6 6 6 6 6 6 4 4 6 4 6 4 6 4 4 4 6 6 6 6 4 6 6 6 6 6 6 6 6 6 6 6 6 6 0
0 6 6 6 6 6 6 6 6 6 6 6 6 6 6 6 6 6 6 6 6 6 6 6 6 4 6 6 4 6 6 6 6 6 6 4 6 6 6 6 6 6 6 6 6 6 6 6 6 0
0 6 6 6 6 6 6 6 6 6 6 6 6 6 6 6 6 6 6 6 6 6 6 6 4 4 4 6 4 6 6 6 6 6 6 4 6 6 6 6 6 6 6 6 6 6 6 6 6 0
0 6 6 6 6 6 6 6 6 6 6 6 6 6 6 6 6 6 6 6 6 6 6 6 4 4 4 6 6 6 6 6 6 6 6 4 6 6 6 6 6 6 6 6 6 6 6 6 6 0
0 6 6 6 6 6 6 6 6 6 6 6 6 6 6 6 6 6 6 6 6 6 6 6 6 6 4 4 4 4 4 4 4 4 4 6 6 6 6 6 6 6 6 6 6 6 6 6 6 0
0 6 6 6 6 6 6 6 6 6 6 6 6 6 6 6 6 6 6 6 6 6 6 6 6 6 6 6 4 6 6 6 6 6 6 6 6 6 6 6 6 6 6 6 6 6 6 6 6 0
0 6 6 6 6 6 6 6 6 6 6 6 6 6 6 6 6 6 6 6 6 6 6 6 6 6 6 6 6 6 6 6 6 6 6 6 6 6 6 6 6 6 6 6 6 6 6 6 6 0
0 6 6 6 6 6 6 6 6 6 6 6 6 6 6 6 6 6 6 6 6 6 6 6 6 6 6 6 6 6 6 6 6 6 6 6 6 6 6 6 6 6 6 6 6 6 6 6 6 0
0 6 6 6 6 6 6 6 6 6 6 6 6 6 6 6 6 6 6 6 6 6 6 6 6 6 6 6 6 6 6 6 6 6 6 6 6 6 6 6 6 6 6 6 6 6 6 6 6 0
0 6 6 6 6 6 6 6 6 6 6 6 6 6 6 6 6 6 6 6 6 6 6 6 6 6 6 6 6 6 6 6 6 6 6 6 6 6 6 6 6 6 6 6 6 6 6 6 6 0